!%%%%%%%%%%%%%%%%%%%%%%%%%%%@ !%%%%%%%%%%%%%%%%%%%%%%%%%%%@
^ & & & & & & & & & & & & & ^ ^ & & & & & & & & & & & & & ^
^ & !%%%%%%%@ & !%%%%%%%@ & ^ ^ & !%%%%%%%@ & !%%%%%%%@ & ^
^ & ^       ^ & ^       ^ & ^ ^ & ^       ^ & ^       ^ & ^
^ & #%%%%%%%$ & #%%%%%%%$ & #%$ & #%%%%%%%$ & #%%%%%%%$ & ^
^ & & & & & & & & & & & & & & & & & & & & & & & & & & & & ^
^ & !%%%%%%%@ & !%@ & !%%%%%%%%%%%%%@ & !%@ & !%%%%%%%@ & ^
^ & #%%%%%%%$ & ^ ^ & #%%%%%@ !%%%%%$ & ^ ^ & #%%%%%%%$ & ^
^ & & & & & & & ^ ^ & & & & ^ ^ & & & & ^ ^ & & & & & & & ^
#%%%%%%%%%%%@ & ^ #%%%%%@ & ^ ^ & !%%%%%$ ^ & !%%%%%%%%%%%$
            ^ & ^ !%%%%%$ & #%$ & #%%%%%@ ^ & ^            
            ^ & ^ ^ & & & & & & & & & & ^ ^ & ^            
            ^ & ^ ^ & !%%%%%%%%%%%%%@ & ^ ^ & ^            
%%%%%%%%%%%%$ & #%$ & ^             ^ & #%$ & #%%%%%%%%%%%%
              & & & & ^             ^ & & & &              
%%%%%%%%%%%%@ & !%@ & ^             ^ & !%@ & !%%%%%%%%%%%%
            ^ & ^ ^ & #%%%%%%%%%%%%%$ & ^ ^ & ^            
            ^ & ^ ^ & & & & & & & & & & ^ ^ & ^            
            ^ & ^ ^ & !%%%%%%%%%%%%%@ & ^ ^ & ^            
!%%%%%%%%%%%$ & #%$ & #%%%%%@ !%%%%%$ & #%$ & #%%%%%%%%%%%@
^ & & & & & & & & & & & & & ^ ^ & & & & & & & & & & & & & ^
^ & !%%%%%%%@ & !%%%%%%%@ & ^ ^ & !%%%%%%%@ & !%%%%%%%@ & ^
^ & #%%%%%@ ^ & #%%%%%%%$ & #%$ & #%%%%%%%$ & ^ !%%%%%$ & ^
^ & & & & ^ ^ & & & & & & & & & & & & & & & & ^ ^ & & & & ^
#%%%%%@ & ^ ^ & !%@ & !%%%%%%%%%%%%%@ & !%@ & ^ ^ & !%%%%%$
!%%%%%$ & #%$ & ^ ^ & #%%%%%@ !%%%%%$ & ^ ^ & #%$ & #%%%%%@
^ & & & & & & & ^ ^ & & & & ^ ^ & & & & ^ ^ & & & & & & & ^
^ & !%%%%%%%%%%%$ #%%%%%@ & ^ ^ & !%%%%%$ #%%%%%%%%%%%@ & ^
^ & #%%%%%%%%%%%%%%%%%%%$ & #%$ & #%%%%%%%%%%%%%%%%%%%$ & ^
^ & & & & & & & & & & & & & & & & & & & & & & & & & & & & ^
#%%%%%%%%%%%%%%%%%%%%%%%%%%%%%%%%%%%%%%%%%%%%%%%%%%%%%%%%%$